0
87
-2
21
0000000000000000000000000000000000000000000000000000000000000000000000000000000000000000
0000000000000000000000000000000000000000000000000000000001111111111111111111111111111110
0000000000000000000000000000000000000000000000000000000001111111111000011101111000000010
0000000000000000000000000000000000000000000000000000000001111111111000001111111000000010
0000000000000000000000000000000000000000000000000000000001100000111000000111110000000010
0000000000000000000000000000000000000000000000000000000001100000100000011111100100000010
0000000000000000000000000000000000000000000000000000000001000000000000011100000000000010
0000000000000000000000000000000000000000000000000000000001000000011000111100000000000010
0000000000000000000000000000000000000000000000000000000001101000000000111000001100000010
0000000000000000000000000000000000000000000000000000000001011000000011000000011000000010
0000000000000000000000000000000000000000000000000000000001001000000000000001100000000010
0000000000000000000000000000000000000000000000000000000001101000001000000100101100000010
0000000000000000000000000000000000000000000000000000000001001000000000100001100000000010
0000000000000000000000000000000000000000000000000000000001111000000001000000011100000010
0000000000000000000000000000000000000000000000000000000001000000000111000011100000000010
0000000000000000000000000000000000000000000000000000000001001100000000000000010100000010
0000000000000000000000000000000000000000000000000000000001110000011110000000000000000010
0000000000000000000000000000000000000000000000000000000001001011010000000000000000000010
0000000000000000000000000000000000000000000000000000000001000000000000000000000000000010
0000000000000000000000000000000000000000000000000000000001000000000000000000000000000010
0000000000000000000000000000000000000000000000000000000001000000000000000000000000000010
0000000000000000000000000000000000000000000000000000000001000000000000000000000000000010
0000000000000000000000000000000000000000000000000000000001000000000000000000000000000010
0000000000000000000000000000000000000000000000000000000001111111111111111111111111111110
