-1
87
-2
29
00000000000000000000000000000000000000000000000000000000000000000000000000000000000000000
00000000000000000000000000000000000000000000000000000000000000000000000000000000000000000
00000000000000000000000000000000000000000000000000000000000000000000000000000000000000000
00000000000000000000000000000000000000000000000000000000000000000000000000000000000000000
00000000000000000000000000000000000000000000000000000000000000000000000000000000000000000
00000000000000000000000000000000000000000000000000000000000000000000000000000000000000000
00000000000000000000000000000000000000000000000000000000000000000000000000000000000000000
00000000000000000000000000000000000000000000000000000000000000000000000000000000000000000
00000000000000000000000000000000000000000000000000000000000000000000000000000000000000000
00000000000000000000000000000000000000000000000000000000000000000000000000000000000000000
00000000000000000000000000000000000000000000000000000000000000000000000000000000000000000
00000000000000000000000000000000000000000000000000000000000000000000000000000000000000000
00000000000000000000000000000000000000000000000000000000000000000000000000000000000000000
00000000000000000000000000000000000000000000000000000000000000000000000000000000000000000
00000000000000000000000000000000000000000000000000000000000000000000000000000000000000000
00000000000000000000000000000000000000000000000000000000000000000000000000000000000000000
00000000000000000000000000000000000000000000000000000000000000000000000000000000000000000
01111111111111111111111111111110000000000000000000000000000000000000000000000000000000000
01011100011101110001110100111110000000000000000000000000000000000000000000000000000000000
01011100011101110001110000011110000000000000000000000000000000000000000000000000000000000
01011100011101110001110100111110000000000000000000000000000000000000000000000000000000000
01011100011101110001110100111110000000000000000000000000000000000000000000000000000000000
01000000000000000000000000000010000000000000000000000000000000000000000000000000000000000
01000000000000000000000000000010000000000000000000000000000000000000000000000000000000000
01000000000000000000000000000010000000000000000000000000000000000000000000000000000000000
01111000000000000000000000111110000000000000000000000000000000000000000000000000000000000
01111000000000000000000000111110000000000000000000000000000000000000000000000000000000000
01111000000000000000000000111110000000000000000000000000000000000000000000000000000000000
01111111110001111111111111111110000000000000000000000000000000000000000000000000000000000
00000000010001000000000000000000000000000000000000000000000000000000000000000000000000000
00000000000000000000000000000000000000000000000000000000000000000000000000000000000000000
00000000000000000000000000000000000000000000000000000000000000000000000000000000000000000
